W W W W W W W W W W W W W W W W W W W
W S S S S S S S S S S S S S S S S S W
W S W W S W W W W W W W W W S W W S W
W S S S S S S S S S S S S S S S S S W
W S W W W W S W W W W W S W W W W S W
W S S S S W S S S W S S S W S S S S W
W S W W Q W W W E W E W W W Q W W S W
W S S S S W E E E E E E E W S S S S W
W S W W W W E W E W E W E W W W W S W
W S S S S E G W G R G W G E S S S S W
W S W W S W E W W W W W E W S W W S W
W S S S S W E E E E E E E W S S S S W
W S W W S W E W W W W W E W S W W S W
W S S S S S S S Q W Q S S S S S S S W
W S W W S W W W W W W W W W S W W S W
W S S W S S S S S P S S S S S W S S W
W W S W S W S W W W W W S W S W S W W
W S S S S W S S S W S S S W S S S S W
W S W W W W W W S W S W W W W W W S W
W S S S S S S S S S S S S S S S S S W
W W W W W W W W W W W W W W W W W W W